0,0,0,0,0,1,8,1,0,0,0,0,0,0,0,1,8,1,0,0,0,0,0,0,0,1,8,1,1,1,1,1,0,1,1,1,8,1,1,0,1,1,1,1,1,1,8,1,3,1,1,1,1,1,1,1,8,1,0,0,0,0,1,0,0,0,1,1,0,0,1,8,1,1,1,0,3,1,1,1,1,8,1,1,1,1,1,1,1,1,1,8,1,3,1,3,3,3,1,1,1,8,1,1,1,1,1,0,1,1,1,8,1,1,1,1,1,1,1,0,0,0,1,1,1,8,1,1,1,1,1,1,1,1,1,8,1,1,1,0,1,0,1,1,1,8,1,1,1,3,1,1,1,1,1,1,1,0,1,1,8,1,1,1,1,1,1,1,1,0,0,0,1,1,0,1,8,1,1,1,1,1,1,1,1,1,8,1,1,1,1,1,3,1,1,1,8,1,0,0,0,1,1,1,1,8,1,1,1,1,0,0,0,0,0,0,0,0,0,0,0,0,0,1,1,1,1,1,0,0,0,1,1,1,1,1,1,1,1
0,0,0,0,0,1,1,1,0,0,0,0,0,0,0,1,1,1,0,0,0,0,0,0,0,1,1,1,1,1,1,1,1,1,1,1,1,3,3,1,1,1,1,1,1,1,1,1,1,1,0,0,5,1,1,1,1,1,1,0,0,1,1,1,0,1,1,1,3,3,3,1,1,1,1,1,1,2,2,2,1,1,3,3,1,1,1,1,1,0,1,1,1,3,1,4,4,4,1,0,0,1,1,1,0,1,1,1,0,1,1,1,1,1,1,9,1,1,1,1,0,1,1,1,1,1,1,1,1,0,1,1,1,1,1,1,1,3,1,1,0,0,1,1,1,1,1,1,1,1,3,1,1,1,1,1,1,1,1,1,1,1,1,1,1,1,1,1,1,1,0,1,1,0,0,0,1,1,1,0,1,1,2,2,2,1,1,1,1,1,1,2,4,2,1,1,1,1,1,0,1,1,1,1,1,1,1,1,1,1,1,1,1,1,1,1,1,1,1,0,0,0,1,1,1,1,1,1,1,1,0,1,1,0,0,1,1,1,1
1,1,1,1,1,1,1,1,1,1,1,1,0,1,1,1,1,1,1,1,1,1,0,1,1,1,1,1,1,1,1,1,3,1,1,4,4,2,3,2,2,2,3,1,1,1,2,2,2,1,0,1,1,1,0,1,1,1,1,0,0,1,1,1,1,1,1,1,3,3,3,1,1,1,0,1,1,2,1,2,9,1,1,3,1,0,0,1,1,1,1,2,2,4,3,4,3,4,1,3,1,1,1,1,1,1,1,1,0,1,4,4,4,1,0,1,1,1,1,1,1,1,1,1,3,3,3,1,1,1,1,5,0,1,1,1,1,1,3,1,1,0,1,1,1,1,1,3,1,1,1,1,1,1,1,1,1,1,1,1,1,1,3,3,1,0,1,1,1,1,1,1,1,1,1,1,1,9,1,1,1,1,2,1,2,4,3,4,4,4,1,4,3,2,1,9,1,1,1,1,1,1,1,5,1,2,4,2,1,1,2,2,4,3,1,1,1,1,1,1,1,1,1,1,1,1,1,1,1,1,0,1,1,0,0,1,1,1,1
1,1,1,1,1,1,1,1,1,1,1,1,1,1,1,1,3,1,5,1,1,1,1,1,1,1,5,1,1,1,1,3,3,1,1,4,3,2,1,2,3,4,3,1,1,1,4,3,2,1,3,1,1,1,1,1,3,1,1,1,1,1,1,1,1,1,1,1,3,1,3,1,1,1,5,1,2,2,1,2,2,4,4,3,0,0,0,1,1,1,5,2,1,4,4,4,3,2,2,1,1,1,3,3,1,9,1,3,1,1,4,1,4,1,1,1,1,1,1,1,1,1,1,2,2,4,3,3,1,1,1,1,3,1,3,1,1,3,1,1,1,1,1,1,1,1,1,1,1,1,1,1,1,1,1,1,1,1,1,1,1,3,3,1,1,1,1,1,1,1,1,1,1,1,2,2,2,1,9,3,3,1,2,1,1,4,4,4,1,2,3,4,3,2,1,1,1,1,1,1,1,1,1,1,1,4,3,2,1,1,2,1,4,3,1,1,1,1,1,1,1,1,1,1,1,1,1,1,1,1,1,1,1,1,1,1,1,1,1
1,1,1,1,1,1,1,1,1,1,1,1,1,1,1,3,3,1,1,1,1,1,1,1,1,1,1,1,1,1,1,3,3,3,1,4,1,4,1,4,3,4,1,1,5,1,4,3,2,1,4,2,2,1,1,3,3,1,1,1,1,1,1,1,1,1,1,1,1,1,1,1,1,1,5,2,2,1,1,3,1,1,4,3,1,5,0,1,3,3,1,2,1,3,3,3,3,1,2,2,3,1,3,1,1,1,4,4,4,3,4,3,4,1,2,2,4,1,1,1,1,1,1,2,1,4,3,1,1,1,1,1,2,2,4,1,3,1,5,1,1,1,1,1,3,1,1,1,1,1,1,1,1,1,1,1,1,1,1,1,1,1,3,3,1,1,1,1,1,1,1,1,1,1,2,3,2,1,1,3,3,3,4,1,5,5,3,1,1,2,1,2,5,2,3,1,1,1,1,1,1,1,1,1,1,4,3,2,1,3,4,5,2,1,5,3,1,1,1,1,1,1,1,1,1,1,1,1,1,1,1,1,1,1,1,1,1,1,1
2,2,6,2,2,2,2,2,2,2,4,2,2,2,2,4,4,2,2,2,2,2,2,2,2,2,2,2,2,2,2,4,4,4,2,4,3,4,3,4,3,4,4,2,2,3,4,1,2,1,4,3,2,2,2,4,4,4,4,2,2,2,10,2,2,11,2,2,2,2,1,1,1,1,3,4,3,1,5,3,1,1,4,2,2,5,3,1,3,1,1,2,1,3,3,3,3,1,1,2,4,3,3,1,1,1,2,3,2,3,4,3,4,3,2,1,4,2,10,2,2,11,2,2,1,4,3,1,3,1,1,1,2,1,4,4,4,2,2,4,4,4,2,2,4,2,2,2,2,12,2,2,2,2,2,2,2,13,2,2,4,4,4,4,2,2,2,2,10,2,2,11,2,2,2,3,2,1,3,3,3,3,4,1,5,5,3,1,1,2,1,2,1,4,4,2,2,10,2,2,11,2,2,2,1,4,1,4,1,4,2,1,2,1,2,4,4,2,2,2,2,2,14,2,2,2,2,2,15,2,2,2,2,2,2,2,2,2,7
1,1,1,1,1,1,1,1,1,1,1,1,1,1,1,3,3,1,1,1,1,1,1,1,1,1,1,1,1,1,1,3,3,1,1,3,3,2,1,4,1,1,3,1,4,4,4,1,2,1,4,3,1,1,1,3,3,1,1,1,1,1,1,1,1,1,1,1,1,2,2,1,1,3,3,4,3,1,3,3,3,1,1,1,2,5,9,4,2,2,1,2,1,1,3,3,1,0,1,5,4,4,3,1,2,2,4,3,2,3,4,1,4,3,2,1,3,1,1,1,1,1,1,1,1,4,1,3,3,3,1,3,2,1,1,9,3,1,1,1,1,1,1,1,1,3,1,1,1,1,1,1,1,1,1,1,1,1,1,1,1,1,3,3,1,1,1,1,1,1,1,1,1,1,1,3,2,1,3,3,3,3,4,1,0,5,3,3,3,2,2,2,3,3,3,1,1,1,1,1,1,1,1,2,1,4,9,4,4,4,3,3,4,9,2,3,1,1,1,1,1,1,1,1,1,1,1,1,1,1,1,1,1,1,1,1,1,1,1
1,1,1,1,1,1,1,1,1,1,1,1,1,1,1,1,3,1,1,1,1,1,1,1,1,1,1,5,1,1,1,1,1,3,1,3,1,2,5,4,1,3,3,1,1,3,3,1,2,2,4,1,1,1,1,1,1,1,1,1,1,1,1,1,1,1,1,1,1,1,2,4,1,3,1,4,3,0,3,3,1,1,1,1,2,1,1,4,1,2,1,2,1,1,3,1,1,0,1,5,1,4,4,1,2,5,3,1,2,3,4,3,4,1,2,9,1,1,1,1,1,1,1,1,1,2,1,1,1,3,1,3,2,1,1,1,3,1,1,1,1,1,1,1,1,1,1,1,1,1,1,1,1,1,1,1,1,1,1,1,1,1,3,3,3,1,1,1,1,1,1,1,1,0,0,3,2,3,4,4,4,3,4,3,0,0,3,3,1,1,1,1,1,1,1,1,1,1,1,1,1,1,1,2,1,2,1,3,3,1,1,1,2,3,2,1,1,1,1,1,1,1,1,1,1,1,1,1,1,1,1,1,1,1,1,1,1,1,1
1,1,1,1,1,1,1,1,1,1,1,1,1,1,1,1,3,3,1,1,1,1,1,1,1,1,1,1,1,1,1,1,3,3,1,3,1,2,2,2,1,3,3,1,1,1,1,1,1,1,3,1,1,1,0,1,1,1,1,0,0,1,1,1,1,1,1,1,3,1,1,2,4,4,4,4,3,1,9,1,3,1,0,1,2,1,4,4,1,2,2,2,1,1,1,1,1,1,1,1,1,1,4,2,2,1,0,1,2,5,4,3,4,1,2,1,1,1,1,1,1,1,1,1,1,2,1,1,1,4,4,2,2,1,1,1,3,3,1,1,1,1,1,1,1,1,1,1,1,3,1,1,1,1,1,1,1,1,1,1,1,1,1,3,1,1,1,0,1,1,1,1,1,0,0,3,2,3,4,3,4,3,4,3,0,0,3,1,1,1,1,1,1,1,1,9,1,1,1,1,1,1,1,2,2,2,1,3,3,1,1,1,2,4,2,1,1,1,1,1,1,1,1,1,1,1,1,1,1,1,0,1,1,0,0,1,1,1,1
1,1,1,1,1,1,1,1,1,1,1,1,0,1,1,1,3,3,1,1,1,1,0,1,1,1,1,1,1,1,1,1,1,1,1,1,1,1,1,1,1,1,3,1,1,1,1,9,1,0,1,1,5,1,1,1,1,1,1,0,0,1,1,1,0,1,1,0,3,3,1,1,1,1,1,3,3,1,1,1,1,1,1,1,2,2,2,3,3,3,1,1,1,1,1,1,1,1,0,1,1,1,1,1,1,1,1,1,2,2,2,1,2,2,2,1,1,1,1,1,0,1,1,1,1,2,2,2,2,4,3,1,1,1,1,1,0,3,1,0,1,0,1,1,1,1,1,1,1,1,1,1,1,1,1,1,1,1,1,1,1,1,0,1,1,1,1,1,1,1,0,1,1,1,0,3,2,4,4,3,4,4,4,1,0,0,1,1,1,1,0,1,1,1,1,1,1,1,1,0,1,1,1,5,1,1,1,3,1,1,1,1,1,1,1,1,1,1,1,0,0,0,1,1,1,1,1,1,1,1,0,1,1,0,0,1,1,1,1
0,0,0,0,0,0,0,0,0,0,0,0,0,0,0,0,0,0,0,0,0,0,0,0,0,0,0,0,1,1,1,1,1,1,1,1,1,1,1,1,0,1,1,1,1,1,1,1,0,0,0,1,1,1,1,1,1,1,0,0,0,0,1,0,0,0,1,0,3,3,3,1,1,1,1,1,1,1,1,0,1,1,1,1,1,1,1,1,1,1,1,1,1,1,1,1,0,1,1,1,1,1,1,1,1,1,1,1,1,1,1,1,1,1,1,9,1,1,1,0,0,0,1,1,1,1,1,1,1,1,1,5,0,1,1,1,1,1,1,1,0,0,1,1,1,1,1,1,1,1,1,1,3,1,1,1,1,0,1,1,1,1,1,1,1,1,1,1,1,0,0,0,1,1,1,1,1,9,1,3,3,1,1,1,1,1,9,3,1,1,0,1,1,1,1,1,1,1,0,0,0,1,1,1,1,1,1,1,1,1,0,0,0,0,0,0,0,0,0,0,0,0,0,1,1,1,1,1,0,0,0,1,1,1,1,1,1,1,1
,,,,,,,,,,,,,,,,,,,,,,,,,,,,,,,,,,,,,,,,,,,,,,,,,,,,,,,,,,,,,,,,,,,,,,,,,,,,,,,,,,,,,,,,,,,,,,,,,,,,,,,,,,,,,,,,,,,,,,,,,,,,,,,,,,,,,,,,,,,,,,,,,,,,,,,,,,,,,,,,,,,,,,,,,,,,,,,,,,,,,,,,,,,,,,,,,,,,,,,,,,,,,,,,,,,,,,,,,,,,,,,,,,,,,,,,,,,,,,
,,0段,,,,,5段,,,,,10段,,,,,15段,,,,,20段,,,,,25段,,,,,30段,,,,,,,,,,,59段,,,,,,,,,,,,,,,,,,,90段,,,98段,,,,,,,108段,,,,,,121段,,,126段,,130段,,,,,142段,,,,154段,,,,161段,,,,,,,175段,,179段,,183段,,190段,,199段,,,,,,,218段,,,226段,,,231段,,,,241段,,,,,251段,,,,,,,,260段,,,,,,,,268段,,,,,,,,,,,,,,,,,,,371段,,,379段,,,,385段,,393段,,,,401段,,411段,,,416段,,419段,,425段,,,,,,,440段,,,448段,,450段,,465段,,473段,,479段,,,486段,,494段,,,,,,,,,496段,,,,,,,,,,,,,,,,
0,,,,,,,,,,,,,,,,,,18,,,,,,,,26,27,,,,,,,,,,,38,,,,,,44,,,47,,,,,52,,,,,,,,,,,,,,,,,,,,,,74,,,,78,,80,,,,,85,86,,,,90,,,,,,,,,99,,,,,,105,,,,109,,,,,,115,,,,,,,,,,,,,,,,131,,,,135,,,138,,,,,,,,,,,,,,,,,,,,,,,,,,,,,,,,,,,,,,,177,178,,,,,,184,185,186,,,,,,192,,,195,,,,,,,,203,,,206,,,,,211,,213,214,,,,,,,,,,,,,,,,,,,,,,,,
