0,0,0,0,0,0,0,0,0,0,0,0,0,1,1,1,0,0,0,0,0,0,0,0,0,0,1,1,1,1,1,1,1,1,1,1,1,1,1,1,1,1,1,1,1,1,1,1,1,1,1,1,1,1,0,0,0,0,0,1
0,0,0,0,0,0,0,0,0,0,0,0,0,1,1,1,0,0,0,0,0,0,0,0,0,0,1,1,1,1,1,1,1,1,1,3,3,1,1,1,3,1,1,1,2,2,2,1,1,1,5,1,1,1,1,0,0,0,1,1
1,1,1,1,1,1,1,1,1,1,0,1,1,1,1,1,1,1,1,1,0,1,1,1,1,1,1,1,1,3,3,3,1,4,4,4,3,2,2,2,3,1,1,1,2,1,2,1,1,1,1,1,0,1,1,0,0,0,1,1
1,1,1,1,1,4,4,4,4,1,1,1,1,1,1,2,2,2,1,1,1,1,1,1,1,1,1,1,1,3,3,3,1,4,3,4,3,2,3,4,3,1,1,1,2,1,2,1,1,1,1,1,1,1,1,1,1,1,1,1
1,1,1,1,1,4,1,1,4,1,1,1,1,1,1,2,1,2,1,1,1,1,1,1,1,1,1,1,1,3,3,3,1,4,3,4,3,4,3,4,3,1,1,1,2,1,2,1,2,2,2,1,1,1,1,1,1,1,1,1
6,2,2,2,2,2,1,1,2,2,2,2,2,1,1,2,1,2,2,2,2,2,2,2,2,2,2,2,2,4,4,4,2,4,3,4,3,4,3,4,4,2,2,2,2,0,2,1,2,1,2,2,2,2,2,2,2,2,7,1
1,1,1,1,1,1,1,1,1,1,1,1,2,1,1,2,1,1,1,1,1,1,1,1,1,1,1,1,1,3,3,3,1,3,3,4,1,4,3,3,3,1,1,1,1,1,2,1,2,1,1,1,1,1,1,1,1,1,1,1
1,1,1,1,1,1,1,1,1,1,1,1,2,2,2,2,1,1,1,1,1,1,1,1,1,1,1,1,1,3,3,3,1,3,3,2,1,4,1,3,3,1,1,1,1,1,2,2,2,1,1,1,1,1,1,1,1,1,1,1
1,1,1,1,1,1,1,1,1,1,1,1,1,1,1,1,1,1,1,1,1,1,1,1,1,1,1,1,1,3,3,3,1,3,3,2,2,2,1,1,3,1,1,1,1,1,1,1,1,1,1,1,0,1,1,0,0,0,1,1
1,1,1,1,1,1,1,1,1,1,0,1,1,1,1,1,1,1,1,1,0,1,1,1,1,1,1,1,1,1,1,1,1,3,3,1,1,1,1,1,3,1,1,1,1,5,1,1,1,1,5,1,1,1,1,0,0,0,0,1
1,0,0,0,0,0,0,0,0,0,0,0,0,0,0,0,0,0,0,0,0,0,0,0,0,0,1,1,1,1,1,1,1,1,1,1,1,1,1,1,1,1,1,1,1,1,1,1,1,1,1,1,1,1,0,0,0,0,0,1